***********************************************************
*..............................**********************.....*
*.***********.............................................*
*.......................****************..................*
*.........................................................*
*.........................................................*
*.....................*****************...................*
*..........................................*****..........*
*.........................................................*
*...............................*******************.......*
*.........************....................................*
*.........................................................*
*.........................................................*
*.................................************............*
*.........................................................*
*.........................................................*
*........................****************************.....*
*...........*********.....................................*
*.........................................................*
*....****..............**********.........................*
*.........................................................*
*.........................................................*
*...............................**************............*
*.........................................................*
*.........................................................*
*.........................................................*
*.........................................................*
*.....*******************.................................*
*.........................................................*
***********************************************************