***********************************************************
*.........................................................*
*.........................................................*
*.........................................................*
*.........................................................*
*.........................................................*
*...........................*.............................*
*...........................*.............................*
*...........................*.............................*
*..................******************.....................*
*...........................*.............................*
*...........................*.............................*
*...........................*.............................*
*...........................*.............................*
*...........................*.............................*
*...........................*.............................*
*.....................************........................*
*.........................................................*
*.........................................................*
*.........................................................*
*.........................................................*
*.........................................................*
*.........................................................*
*.........................................................*
*.........................................................*
*.........................................................*
*.........................................................*
*.........................................................*
*.........................................................*
***********************************************************